R 600 500
NO ./textures/Spearreswalls/4.xpm
SO ./textures/Spearreswalls/5.xpm
WE ./textures/Spearreswalls/6.xpm
EA ./textures/Spearreswalls/7.xpm
S ./textures/Spearressprites/9.xpm
F 29,191,192
C 75,69,148

11111111111111111111111111111 11111111111111111111111111111
10100000111000000000000100010 00100000000000000000000100011
10110000011100E00000000000000 00000000001100000111011110001
11110111111101011100000010001 11110111111111000001010010001
11000000110101011100000210001 10000000000000001100000010001
10000000000000001101010010001 11000000110101001111011110011
11111111111111111111111111111 11111111111111111111111111111
