R 2000 1500
NO ./textures/Spearreswalls/4.xpm
SO ./textures/Spearreswalls/182.xpm   
WE ./textures/Spearreswalls/25.xpm
EA ./textures/Spearreswalls/35.xpm
S ./textures/Spearressprites/10.xpm
F 255, 87, 51
C 75, 69, 148

11111111111111111111111111111 11111111111111111111111111111
10100000111000000000000100010 00100000000000000200000100011
10110000011100E00000000002000 00000000001100000111011110001
11110111111101011100200010001 1111011111111100000101001001
11000000110101011100000010001 10000000000000001100000010001
10000000000000001101010010001 11000000110101001111011110011
11111111111111111111111111111 11111111111111111111111111111
