11111111111111111111111111111 11111111111111111111111111111
10100000111000000200000100011 00100000000000000000000100011
10110000011100000000000010001 10000000001100000111011110001
11110111111111011100000010001 111101111111110N1101010010001
11000000110101011100000010001 10002000000000001100000010001
10000000000000001101010010001 11000000110101011111011110001
11111111111111111111111111111 11111111111111111111111111111
