R 600 500
NO ../textures/Spearreswalls/1.bmp
SO ../textures/Spearreswalls/2.bmp
WE ../textures/Spearreswalls/3.bmp
EA ../textures/Spearreswalls/4.bmp
S ../textures/Spearresprites/18.bmp
F 29,191,192
C 75,69,148

11111111111111111111111111111 11111111111111111111111111111
10100000111000000200000100011 00100000000000000000000100011
10110000011100E00000000010001 10000000001100000111011110001
11110111111101011100000010001 11110111111111000001010010001
11000000110101011100000010001 10002000000000001100000010001
10000000000000001101010010001 11000000110101001111011110011
11111111111111111111111111111 11111111111111111111111111111
