R 1920 1080
NO ./path_to_the_north_texture
SO ./path_to_the_south_texture
WE ./path_to_the_west_texture
EA ./path_to_the_east_texture
S ./path_to_the_sprite_texture
F 220,100,0
C 225,30,0

11111111111111111111111111111 11111111111111111111111111111
10100000111000000200000100011 00100000000000000000000100011
10110000011100000000000010001 10000000001100000111011110001
11110111111101011100000010001 111101111111110N1101010010001
11000000110101011100000010001 10002000000000001100000010001
10000000000000001101010010001 11000000110101011111011110011
11111111111111111111111111111 11111111111111111111111111111
